Merkmal -> characteristics
Bauwerk -> construction
Blut -> blood
Brot -> bread
Zigarette -> cigarette
Umstände -> circumstances
sonst -> else
gleich -> equal
Seil -> cord
Bäckerei -> bakery
glauben -> believe
Tasse -> cup
Adresse -> address
weil -> because
Jahrhundert -> century
Kamm -> comb
Wohnung -> apartment
irgend jemand -> anyone
Zoll -> customs
Strand -> beach
breit -> broad
Boot -> boat
Wüste -> desert
entkommen -> escape
Zuweisung -> assignment
werden -> become
Menge -> crowd
Besen -> broom
Auge -> eye
Kalb -> calf
sich nähern -> approach
Café -> café
Hautfarbe -> complexion
demokratisch -> democratic
Bank -> bank
beladen -> charge
Feind -> enemy
kochen -> boil
Geschäfte -> affairs
erwachen -> awake
alles -> everything
Kontrolle -> control
Direktor -> director
Teppich -> carpet
Kleider -> clothes
Fahrrad -> bicycle
Verbindung -> communication
Dezember -> December
Vogel -> bird
Ausrüstung -> equipment
Grund -> cause
besprechen -> discuss
jeder -> any
Gepäck -> baggage
betreffen -> concern
Flugzeug -> airplane
jährlich -> annual
schlechter -> bad
laufend -> current
Kirche -> church
Waffen -> arms
Alkohol -> alcohol
veränderlich -> changable
alt -> ancient
besonders -> especially
Beweis -> evidence
beruhen auf -> based
verteilen -> distribute
Ankunft -> arrival
Kreis -> circle
alle -> all
Verteidigung -> defense
besorgt -> afraid
jeden -> every
pleite -> broke
passend -> appropriate
kulturell -> cultural
enthalten -> contain
kühlen -> chill
eigentlich -> actually
Wirkung -> effect
fortgeschritten -> advanced
gewiss -> certain
Grundlage -> base
ankommen -> arrive
essen -> eat
bürgerlich -> civil
vergleichen -> compare
immer -> always
kaufen -> buy
brennen -> burn
Verwaltung -> administration
und -> and
richtig -> correct
Versuch -> attempt
Budget -> budget
vor -> before
Schmetterling -> butterfly
Tiefe -> depth
Kunst -> art
hell -> bright
Konto -> account
Kultur -> culture
tun -> do
klar -> clear
nachher -> afterwards
doppelt -> double
Staub -> dust
Ellbogen -> elbow
weg -> away
Schublade -> drawer
Geschäft -> business
Ei -> egg
Gebiet -> area
teuer -> dear
gefühlsmässig -> emotional
Papa -> daddy
Pflicht -> duty
Klingel -> bell
Kuchen -> cake
weinen -> cry
Anfrage -> demand
tanzen -> dance
Kapital -> capital
Gebühr -> due
erklären -> explain
Knopf -> button
Schreibtisch -> desk
backen -> bake
entwickeln -> develop
Nachmittag -> afternoon
Gericht -> court
Anspruch -> claim
herrschend -> dominant
Versammlung -> assembly
Ereignis -> event
Lehm -> clay
Rechnung -> bill
Planung -> concept
Rücken -> back
Bier -> beer
Kohl -> cabbage
Verhalten -> conduct
vermeiden -> avoid
erwachsen -> adult
Butter -> butter
Arzt -> doctor
Verband -> association
Haltung -> attitude
Cousin -> cousin
Bär -> bear
Gespräch -> conversation
Keller -> cellar
Kreuz -> cross
Baby -> baby
Benehmen -> behavior
tot -> dead
aufgeweckt -> aware
Esel -> donkey
neben -> beside
Brust -> chest
Porzellan -> china
endlich -> at last
Geburt -> birth
Gesellschaft -> company
Klasse -> class
vollständig -> complete
Ameise -> ant
Schönheit -> beauty
Distrikt -> district
Bar -> bar
Gegensatz -> contrast
als -> as
abreisen -> depart
ergeben -> devoted
Sessel -> armchair
kalt -> cold
entdecken -> discover
verdienen -> earn
elf -> eleven
jemals -> ever
Vieh -> cattle
Schriftstellerin -> author
Brust -> breast
Abteilung -> division
Wahl -> election
zur gleichen Zeit -> at the same time
Biscuit -> biscuit
Konflikt -> conflict
bauen -> build
fähig -> able
Ratsversammlung -> council
kritisch -> critical
zusätzlich -> extra
Arm -> arm
Schale -> bowl
Auswahl -> choice
Koch -> cook
jenseits -> beyond
trocken -> dry
Kredit -> credit
kühl -> cool
überall -> everywhere
obwohl -> although
leicht -> easy
Herausgeber -> editor
Blumenkohl -> cauliflower
Kathedrale -> cathedral
Werbung -> advertisment
werbend -> advertising
Betrag -> amount
Armee -> army
Schauspielerin -> actress
Stück -> bit
Gebäude -> building
ankündigen -> announce
zurück -> back
entscheiden -> decide
kaufen -> buy
Gurke -> cucumber
während -> during
befehlen -> command
Datum -> date
Ball -> ball
Winkel -> angle
höchstens -> at most
Liegenschaft -> estate
direkt -> directly
wie -> as
Frühstück -> breakfast
Anstrengung -> effort
Billigung -> approval
bringen -> bring
schwarz -> black
Geburtstag -> birthday
gewöhnlich -> common
Zweifel -> doubt
sorgen -> care
häuslich -> domestic
Stuhl -> chair
Tante -> aunt
Kunde -> client
Lauf -> course
durch -> across
Dutzend -> dozen
Beistand -> assistance
an -> at
sein -> be
Abteilung -> department
aber -> but
Osten -> east
Speck -> bacon
Luft -> air
Ausgang -> exit
Armbanduhr -> clock
Käse -> cheese
Gefahr -> danger
Auto fahren -> drive
schön -> beautiful
Vorteil -> advantage
ausser -> except
tatsächlich -> actual
Ohr -> ear
Karte -> card
Farbe -> color
kurz -> brief
Künstlerin -> artist
Ausdehnung -> extent
beginnen -> begin
entschlossen -> determined
Abendessen -> dinner
Nutzen -> benefit
Kapitel -> chapter
fragen -> ask
wählen -> choose
Elefant -> elephant
chinesisch -> chinese
beide -> both
erwarten -> expect
beide -> either
zwischen -> between
leer -> empty
Bremse -> brake
Element -> element
gültig sein -> be valid
Gurt -> belt
Hühnchen -> chicken
Komittee -> committee
annehmen -> assume
Entscheidung -> decision
Werbespot -> commercial
Stadt -> city
bestimmen -> determine
ausserdem -> besides
Ende -> end
erscheinen -> appear
entwerfen -> design
Erfahrung -> experience
Geschäftsführer -> executive
unten -> down
strahlend -> brilliant
über -> about
unter -> beneath
gewiss -> certainly
Steak -> beefsteak
Künstler -> artist
Beispiel -> example
Ergebnis -> conclusion
Kerze -> candle
dunkel -> dark
Bucht -> bay
Auslagen -> expenses
über -> above
wirksam -> effective
Krone -> crown
Rübe -> carrot
Kassierer -> cashier
Boden -> bottom
übrigens -> by the way
acht -> eight
lenken -> direct
Korb -> basket
Buch -> book
Fessel -> ankle
Körper -> body
Detail -> detail
Apfel -> apple
Schlafzimmer -> bedroom
Abmachung -> deal
Tätigkeit -> activity
verlangen -> demand
erweitert -> extended
und so weiter -> and so on
fortsetzen -> continue
geniessen -> enjoy
rufen -> call
Kapitän -> captain
Abend -> evening
Wirtschaft -> economy
Handlung -> action
Balkon -> balcony
Kindheit -> childhood
Appetit -> appetite
Metzger -> butcher
Bruder -> brother
zeichnen -> draw
gegen -> against
um -> at
Alter -> age
Experiment -> experiment
Atem -> breath
Vordsitzender -> chairman
Handel -> commerce
im Ausland -> abroad
Tag -> day
jeder -> everyone
schlagen -> beat
zufällig -> by chance
überzeugen -> convince
Tier -> animal
Kuh -> cow
täglich -> daily
Block -> block
Ecke -> corner
wesentlich -> essential
Fahrstuhl -> elevator
Decke -> blanket
zurückkommen -> come back
Bedingung -> condition
teuer -> expensive
geteilt -> divided
angemessen -> adequate
Bluse -> blouse
taub -> deaf
Schlacht -> battle
ausgezeichnet -> excellent
Ziel -> aim
Buchhandlung -> bookshop
verschieden -> different
Chance -> chance
wieder -> again
Verbindung -> connection
Dasein -> existence
zählen -> count
Gegenteil -> contrary
fangen -> catch
Badezimmer -> bathroom
Weihnachten -> christmas
durch -> by
Traum -> dream
vergnügen -> amuse
Ueberzeugung -> conviction
Wagen -> car
Keller -> basement
Gehirn -> brain
Aprikose -> apricot
Bürste -> brush
April -> April
Vereinbarung -> agreement
Besprechung -> conference
Erde -> earth
Verbrennung -> burning
beschreiben -> describe
Sahne -> cream
tragen -> carry
wütend -> angry
heissen -> be called
hinter -> behind
sauber -> clean
bekennen -> confess
unter -> below
Uebung -> exercise
Ente -> duck
Getränk -> beverage
kontaktieren -> contact
Gerät -> device
ungefähr -> approximately
eng -> closely
abwesend -> absent
Brett -> board
Besprechung -> discussion
Leiter -> chief
Richtung -> direction
Wange -> cheek
tief -> deep
ganzer -> entire
angreifen -> attack
erreichen -> achieve
chemisch -> chemical
Daten -> data
schmutzig -> dirty
Inhalt -> content
Erziehung -> education
vor -> ago
einrichten -> establish
Grad -> degree
Unfall -> accident
Tasche -> bag
Bohne -> bean
bitten -> ask
Brücke -> bridge
Kamarad -> comrade
begehren -> desire
Bibel -> bible
unter -> among
Kind -> child
Flasche -> bottle
wechseln -> change
Abfahrt -> departure
kosten -> cost
erschaffen -> create
Glauben -> belief
Gesellschaft -> corporation
Eingang -> entrance
Ausdruck -> expression
etwa -> about
enttäuscht -> disappointed
Lager -> camp
Schokolade -> chocolate
Bett -> bed
äusserst -> extreme
gross -> big
erlauben -> allow
allein -> alone
auswendig -> by heart
trotz -> despite
Uhr -> clock
christlich -> christian
Beweis -> argument
Wolke -> cloud
Paar -> couple
Kinn -> chin
Rat -> advice
Biene -> bee
erwägen -> consider
Zentrum -> center
können -> can
jeder -> everybody
Bad -> bath
Charakter -> character
trinken -> drink
Sammlung -> collection
Zelle -> cell
zusätzlich -> added
Schachtel -> box
gefährlich -> dangerous
Detektiv -> detective
Bäcker -> baker
Zutrauen -> confidence
beigefügt -> additional
Wechsel -> change
Fall -> case
Verbindung -> combination
Kommission -> commission
genug -> enough
irgendwo -> anywhere
auch -> also
zentral -> central
Krankheit -> disease
Kragen -> collar
Vorhang -> curtain
Band -> band
Junge -> boy
Vertrag -> contract
Wette -> bet
Karriere -> career
dramatisch -> dramatic
Säule -> column
Kante -> edge
Herbst -> autumn
schwierig -> difficult
bedecken -> cover
herum -> around
Antwort -> answer
brechen -> break
Kaffee -> coffee
entlang -> along
Hilfe -> aid
Wörterbuch -> dictionary
Grafschaft -> county
Hintergrund -> background
ausdrücken -> express
betrunken -> drunk
Rindfleisch -> beef
nahe -> close
danach -> after that
Banknote -> bank note
fast -> almost
kochen -> cook
Briefumschlag -> envelope
Fähigkeit -> ability
Unterschied -> difference
Kleid -> dress
Achtung -> attention
Land -> country
sterben -> die
Katze -> cat
annehmen -> accept
elektrisch -> electric
elektronisch -> electronic
schwarz -> black
Entwicklung -> development
schon -> already
Bart -> beard
Wettbewerb -> competition
genau -> exactly
wenigstens -> at least
nach -> after
lebendig -> alive
Artikel -> article
Anfang -> beginning
sogar -> even
Knochen -> bone
geschätzt -> estimated
früh -> early
Bürger -> citizen
Kongress -> congress
Dessert -> dessert
Übel -> evil
Anwalt -> attorney
schneiden -> cut
prüfen -> check
August -> August
Verbrechen -> crime
Wecker -> alarm clock
Anblick -> aspect
Club -> club
kommen -> come
existieren -> exist
anwenden -> apply
Schrank -> cupboard
Hund -> dog
zustimmen -> agree
grundlegend -> basic
braun -> brown
Bus -> bus
Kette -> chain
bekanntgeben -> declare
jeder -> each
schlecht -> badly
Distanz -> distance
Küste -> coast
Tochter -> daughter
beschäftigt -> busy
Esszimmer -> dining room
Motor -> engine
besser -> better
bester -> best
Zahnarzt -> dentist
eintreten -> enter
Mantel -> coat
Wohnung -> dwelling
ein anderer -> another
Türe -> door
käuflich -> available
billig -> cheap
langweilg -> boring
vorsichtig -> careful
hinzufügen -> add
zeitgenössisch -> contemporary
Banane -> banana
Wechsel -> exchange
Schauspieler -> actor
bitter -> bitter
Flughafen -> airport
handeln -> act
irgend etwas -> anything
Schriftsteller -> author
Angestellter -> employee
Krise -> crisis
blau -> blue
Energie -> energy
beträchtlich -> considerable
blind -> blind
Aufnahmefähigkeit -> capacity
Kirsche -> cherry
schliesslich -> eventually
Bewegung -> motion
Mund -> mouth
Eisen -> iron
es friert Kälte ein -> it's freezing
lie -> liegen
vierzig -> forty
knife -> Knie
die meisten -> most
neunzig -> ninety
Hoffnung -> hope
lustig -> funny
Monat -> month
Kampf -> fight
frisch -> fresh
like -> Blitz
kennzeichnen -> mark
Gesundheit -> health
neu -> new
Märchen -> fairy tale
lose -> schauen
beenden -> finish
hinein -> into
Nuss -> nut
mich -> me
in -> in
Hammer -> hammer
Fleisch -> meat
menschlich -> human
nett -> nice
lunch -> Mittagessen
Glück -> luck
Serviette -> napkin
Milch -> milk
Feuer -> fire
Freund -> friend
jacket ->  
grundlegend -> fundamental
Zeitung -> newspaper
Bedeutung -> meaning
ich -> I
Januar -> January
anbieten -> offer
interessant -> interesting
Landkarte -> map
holen -> fetch
schwer -> heavy
Mond -> moon
luck -> leise
Eis -> ice
nichts -> nothing
Finger -> finger
brauchen -> need
weder -> nor
Büro -> office
freundlich -> friendly
sich beeilen -> hurry
eng -> narrow
weiblich -> female
Idee -> idea
vielleicht -> maybe
normal -> normal
Zeigefinger -> index finger
kaum -> merely
er -> he
Fliege -> fly
verwickeln -> involve
vergessen -> forget
lock -> Standort
Montag -> Monday
nirgendwo -> nowhere
ein mal -> once
Hitze -> heat
grau -> gray
little -> wenig
hungrig -> hungry
love -> laut
ihn -> him
lead -> legen
Gefallen -> favor
trotz -> in spite of
Mantel -> overcoat
Film -> film
nett -> nice
natürlich -> of course
helfen -> help
vierzehn -> fourteen
Eiskrem -> ice cream
legal -> Bein
gewohnt -> familiar
neunzehn -> nineteen
Maschine -> machine
Natur -> nature
leave -> lernen
gegenüberstehend -> opposite
weg -> off
Huhn -> hen
drinnen -> inside
just -> Juni
Fabrik -> factory
look -> lange
Landstrasse -> highway
life -> lügen
hundert -> hundred
light -> heben
gerne -> gladly
ernähren -> feed
innerer -> inner
jam -> Jacke
verheiratet -> married
Musik -> music
Gabel -> fork
lie -> Bibliothek
Gewehr -> gun
Gras -> grass
Familie -> family
Mitglied -> member
Frau -> Mrs.
vermissen -> miss
Eiche -> oak
es ist heiß -> it's hot
long -> Schloss
keep -> Gerechtigkeit
Minute -> minute
fallen -> fall
Orange -> orange
like -> wie
Messe -> mass
sofort -> immediately
hard -> hard
über -> over
Einfluss -> impact
niemand -> none
neun -> nine
Ernte -> harvest
Million -> million
Mittel -> means
nicken -> nod
pünktlich -> on time
bestellen -> order
Metall -> metal
live -> leben
Gelegenheit -> opportunity
Maximum -> maximum
vier -> four
Roman -> novel
Faktor -> factor
Nase -> nose
Glas -> glass
es ist schneebedeckt -> it's snowy
Zoll -> inch
Vater -> father
Vorderseite -> front
weit -> far
allmählich -> gradually
sich fühlen -> feel
Gans -> goose
length -> Zitrone
weiterer -> further
know -> Messer
Spital -> hospital
gratis -> free
Ehre -> honor
Waren -> goods
anderer -> other
man -> one
laugh -> spät
king -> Art
halten -> hold
viel -> much
Mord -> murder
Hilfe -> help
verletzen -> hurt
erhalten -> obtain
Hand -> hand
unmöglich -> impossible
offiziell -> official
Nahrung -> food
natürlich -> natural
Problem -> issue
hoch -> high
lamp -> See
es ist neblig -> it's foggy
Brunnen -> fountain
Halle -> hall
tatsächlich -> indeed
Freitag -> Friday
nein -> no
Herz -> heart
Fuss -> foot
sich vorstellen -> imagine
Flüssigkeit -> liquid
Liste -> list
hören -> listen
Sinn -> mind
original -> original
Grossvater -> grandfather
Versagen -> failure
light -> leicht
fliegen -> fly
anstatt -> instead
little -> Literatur
wachsen -> grow
riesig -> huge
land -> Lampe
Boden -> ground
früherer -> former
Insekt -> insect
beobachten -> observe
ideal -> ideal
vor -> in front of
Mehl -> flour
treffen -> meet
Mode -> fashion
Form -> form
verboten -> forbidden
Wohnung -> flat
fein -> fine
Name -> name
auf -> on
Nacht -> night
Kerl -> guy
Taschentuch -> handkerchief
kaum -> hardly
Nachrichten -> news
Eigenschaften -> features
fünfzehn -> fifteen
Mass -> measure
Offizier -> officer
frei -> free
Hölle -> hell
schlagen -> hit
hier -> here
falsch -> false
folgen -> follow
Loch -> hole
love -> Liebe
Gruppe -> group
Wald -> forest
bemerken -> notice
Oktober -> October
Gewinn -> gain
Einfluss -> influence
Schinken -> ham
fünf -> five
Held -> hero
kitchen -> Kuss
wie -> how
mehr...als -> more...than
fett -> fat
Goldfisch -> goldfish
lot -> Verlust
Gesicht -> face
für -> for
voll -> full
öffnen -> open
law -> lachen
Mitternacht -> midnight
lightning -> Licht
wenn -> if
von -> from
Maus -> mouse
jetzt -> now
Fleisch -> flesh
Geschichte -> history
late -> letzte
nur -> only
Botschaft -> message
Mittag -> midday
Mädchen -> girl
Hamster -> hamster
let -> weniger
haben -> have
Februar -> February
flach -> flat
kiss -> König
marschieren -> march
Juli -> July 
justice -> nur
viele -> many
lemon -> gesetzlich
Morgen -> orning
Gast -> guest
Wiese -> meadow
alt -> old
gewöhnlich -> ordinary
likely -> mögen
zunehmen -> increase
geschehen -> happen
lady -> Leiter
hassen -> hate
oft -> often
Benzin -> gasoline
herausfinden -> figure out
judge -> sich anschliessen
notwendig -> necessary
erwähnen -> mention
last -> breit
Geld -> money
halb -> half
Handtasche -> handbag
Bild -> image
Grossmutter -> grandmother
January -> Marmelade
Zukunft -> future
labor -> Wissen
Krankenschwester -> nurse
Organisation -> organization
fünfzig -> fifty
low -> lieben
finden -> find
mehr -> more
von -> of
ein -> one
Glauben -> faith
Akte -> file
es ist windig -> it's windy
ladder -> mangeln
orangegelb -> orange
gehen -> go
Ofen -> oven
Herr -> Mr
Arbeitsstelle -> Job
dürfen -> may
Morgen -> morning
Möbel -> furniture
learn -> Anführer
Gelegenheit -> occasion
hängen -> hang
Ferien -> holiday
Insel -> island
mich -> myself
meinen -> mean
mittlerer -> middle
beinhalten -> include
Fräulein -> Miss
nicht -> not
Gas -> gas
Magazin -> magazine
Gott -> God
Meinung -> opinion
long -> lang
Hals -> neck
Interesse -> interest
Mutter -> mother
Blume -> flower
Ziel -> goal
November -> November
machen -> make
Bewegung -> movement
Gefühl -> feeling
Hügel -> hill
large -> Sprache
local -> wohnen
offensichtlich -> obvious
Boden -> floor
heiss -> hot
loud -> Haufen
Wünsche -> greetings
located -> lokal
Spiel -> game
sonst -> otherwise
fliessen -> flow
Spiegel -> mirror
grün -> green
Inhaltsverzeichnis -> index
Mann -> man
Nachbar -> neighbor
sein -> his
Lippe -> lip
vermuten -> guess
Brille -> glasses
Minimum -> minimum
weder...noch -> neither...nor
sich -> oneself
schnell -> fast
literature -> hören
endlich -> finally
vergeben -> forgive
Garten -> garden
nahe -> near
eher -> fairly
last -> letzter
oder -> or
unser -> our
Fisch -> fish
Meile -> mile
left -> weggehen
Methode -> method
Regierung -> government
less -> Länge
library -> Brief
beglückwünschen -> felicitate
leben -> live
klein -> small
Post -> mail
kalt -> cold
glücklich -> happy
Mahlzeit -> meal
wie auch immer -> however
draussen -> outside
vorfallen -> occur
es -> it
kitten -> Küche
Zwiebel -> onion
fehlschlagen -> fail
Berg -> mountain
loss -> verlieren
jump -> Juli
See -> lake
left -> links
leader -> führen
Motor -> motor
Material -> material
gesund -> healthy
Markt -> market
Hotel -> hotel
einladen -> invite
hören -> hear
Angst -> fear
fröhlich -> glad
Schlüssel -> key
Hut -> hat
erster -> first
Hochzeit -> marriage
list -> flüssig
location -> gelegen
nächster -> next
Haus -> house
language -> Land
Gold -> gold
juice -> Richter
Bauernhof -> farm
Mehrheit -> majority
Oel -> oil
geben -> give
Augenblick -> moment
lack -> Arbeit
Gedächtnis -> memory
lift -> Leben
lay -> Recht
unterdessen -> meanwhile
trotzdem -> nevertheless
eigener -> own
wichtig -> important
unabhängig -> independent
niemand -> nobody
allgemein -> general
modern -> modern
Orchester -> orchestra
ehrlich -> fair
Anlagen -> facilities
März -> March
mein -> my
nie -> never
Stunde -> hour
umgehen mit -> handle
Rahmen -> frame
es ist regnerisch -> it's rainy
Fehler -> mistake
grün -> green
bewegen -> move
Fehler -> fault
füllen -> fill
letter -> lassen
Tatsache -> fact
es ist sonnig -> it's sunny
Ehemann -> husband
Gegenstand -> matter
Nachbarschaft -> neighborhood
knee -> Kätzchen
Fuchs -> fox
Minister -> minister
wenig -> few
instandhalten -> maintain
Innere -> interior
anfänglich -> initial
häufig -> frequently
kind -> child
Notiz -> note
schrecklich -> horrible
gut -> good
Kopf -> head
Feld -> field
Nagel -> nail
Lärm -> noise
Art -> manner
wahrscheinlich -> probably
Linie -> line
Zahl -> number
Kraft -> force
auf Wiedersehen -> good-bye
zuhause -> home
Juni -> June
springen -> jump
bekommen -> get
müssen -> must
Nadel -> needle
Norden -> north
verbessern -> improve
know to -> kennen
Haare -> hair
Mai -> May
böse -> nasty
erschrecken -> frighten
Feige -> fig
grau -> grey
fremd -> foreign
Pferd -> horse
Wissen -> knowledge
Laden -> shop
teilen -> share
ernsthaft -> serious
legen -> put
Verkehr -> traffic
Schule -> school
suchen -> seek
Platz -> square
Zahnbürste -> toothbrush
Sicht -> view
Holz -> wood
geduldig -> patient
Recht -> right
geradeaus -> straight
arbeiten -> work
zwölf -> twelve
deswegen -> therefore
gleicher -> same
unüblich -> unusual
Geschlecht -> sex
total -> total
diese -> these
Westen -> west
immer noch -> still
teilweise -> partly
Problem -> problem
vernünftig -> reasonable
Salat -> salad
Jugend -> youth
wir -> we
Kravatte -> tie
bis -> until
Schmied -> smith
Pass -> passport
hübsch -> pretty
Steuern -> taxes
Ton -> tone
das -> that
Wind -> wind
läuten -> ring
Arbeit -> work
Frau -> woman
danken -> thank
Druck -> pressure
Postbüro -> post office
Frühling -> spring
Boden(Erde) -> soil
pflücken -> pick
darstellen -> represent
Schildkröte -> tortoise
Schaf -> sheep
Schwimmbecken -> pool
Präsident -> president
Hals -> throat
sich fragen -> wonder
Weg -> way
danke -> thank you
Welt -> world
Papier -> paper
Uhr -> watch
erlauben -> permit
sprechen -> speak
süss -> sweet
wirklich -> really
Zimmer -> room
Zahn -> tooth
Punkt -> period
Teil -> portion
Onkel -> uncle
Geschenk -> present
plötzlich -> suddenly
Himmel -> sky
berühren -> touch
lesen -> read
Staat -> state
Frage -> question
Lehrer -> teacher
Schritt -> step
gelb -> yellow
Gemälde -> painting
besuchen -> visit
verhältnismässig -> relatively
riechen -> smell
Grund -> reason
Stern -> star
erkennen -> recognize
Kraft -> strength
erfolgreich -> successful
müde -> tired
Stadt -> town
Reis -> rice
annehmen -> suppose
Hof -> yard
gleich -> similar
jemand -> somebody
Erdbeere -> strawberry
Wetter -> weather
rauchen -> smoke
wählen -> vote
damit -> with that
Teil -> part
lehren -> teach
dann -> then
sie -> they
Staubsauger -> vacuum cleaner
Zug -> train
verkaufen -> sell
Sieg -> victory
Schmerz -> pain
dreizehn -> thirteen
Tiger -> tiger
Personal -> staff
stark -> strong
gewinnen -> win
sehr viel -> plenty
Hinblick -> regard
Eltern -> parents
ihr -> you
sich rasieren -> shave
zehn -> ten
Besonders -> particular
Rolle -> role
schiessen -> shoot
Wahrheit -> truth
Religion -> religion
denken -> think
Salz -> salt
Schnecke -> snail
Laden -> store
ganz -> quite
Vorschlag -> proposal
sehen -> see
Quelle -> source
sexuell -> sexual
du -> you
U-Bahn -> underground
abschmecken -> taste
zwei -> two
sechzig -> sixty
Sekretärin -> secretary
Vertrauen -> trust
Forschung -> research
Fortschritt -> progress
Donner -> thunder
irgendwo -> somewhere
Muster -> pattern
Schuss -> shot
Tal -> valley
bald -> soon
Sohn -> son
Kartoffel -> potato
Arbeiter -> worker
Faden -> thread
genügend -> sufficient
Geist -> spirit
Stelle -> spot
Zange -> tongs
Technik -> technique
Zunge -> tongue
anhalten -> stop
beten -> pray
wahr -> true
Dach -> roof
wessen -> whose
Schallplatte -> record
bleiben -> stay
weich -> smooth
einmalig -> unique
regelmässig -> regular
Postkarte -> postcard
ziehen -> pull
dort -> there
Zeichen -> sign
September -> September
Rasse -> race
Suppe -> soup
Wasser -> water
Abendessen -> supper
geringfügig -> slight
sagen -> say
Soldat -> soldier
Reise -> trip
veröffentlichen -> publish
jemand -> someone
stossen -> push
Wirklichkeit -> reality
waschen -> wash
spielen -> play
Turm -> tower
Schiff -> ship
Silber -> silver
Rad -> wheel
bereit -> ready
Schraube -> screw
Ruhe -> silence
heute morgen -> this morning
bis -> till
Zehe -> toe
Form -> shape
Donnerstag -> Thursday
Regen -> rain
Universität -> university
rechts -> right
obwohl -> though
Wert -> value
Sonne -> sun
Ergebnis -> result
erfordern -> require
siebzig -> seventy
dieser -> this
Polizei -> police
Titel -> title
Szene -> scene
Weltall -> universe
Produkt -> product
retten -> save
liefern -> supply
versprechen -> promise
null -> zero
Bahnhof -> station
zu -> to
weit -> vast
als -> than
Vergangenheit -> past
der -> the
weit -> wide
zu viel -> too much
beweisen -> prove
Restaurant -> restaurant
Meer -> sea
Hinterseite -> rear
Magen -> stomach
Geschichte -> story
öffentlich -> public
sauer -> sour
verstehen -> understand
Lösung -> solution
angenehm -> pleasant
erreichen -> reach
singen -> sing
antworten -> reply
Wein -> wine
Spannung -> tension
Semester -> term
gebrauchen -> use
Daumen -> thumb
empfehlen -> suggest
mächtig -> powerful
sechs -> six
drei -> three
selten -> seldom
durch -> through
Anzug -> suit
sich ausruhen -> rest
Dorf -> village
Kugelschreiber -> pen
Bereich -> range
krank -> sick
Fenster -> window
Handel -> trade
noch -> yet
Fernsehen -> television
Person -> person
morgen -> tomorrow
Winter -> winter
wann -> when
sich setzen -> sit
dein -> your
gut -> well
Geheimnis -> secret
Lastwagen -> wagon
Stall -> spider
testen -> test
reich -> rich
Schlange -> snake
Plan -> plan
bedeuten -> signify
Jahr -> year
dünn -> thin
Kellner -> waiter
falls nicht -> unless
gehen -> walk
unter -> under
Wissenschaft -> science
höchster -> supreme
schnell -> quickly
ausgeben -> spend
Baum -> tree
heute -> today
Sommer -> summer
winzig -> tiny
weich -> soft
dreissig -> thirty
Seite -> side
Fürsorge -> welfare
vorschlagen -> propose
gestern -> yesterday
ganz -> whole
laufen -> run
rechtig -> right
Uebung -> practice
Haut -> skin
Regel -> rule
Bild -> picture
Risiko -> risk
passen -> suit
betrachten -> watch
ja -> yes
Sitz -> seat
dick -> thick
lächeln -> smile
Teller -> plate
Kalbfleisch -> veal
passend -> suitable
bis jetzt -> up to now
darin -> within
Eisenbahn -> railroad
Lied -> song
sie -> she
Geschmack -> taste
Tomate -> tomato
Seife -> soap
Kurs -> rate
hässlich -> ugly
sechzehn -> sixteen
wollen -> want
welcher -> which
Ehefrau -> wife
Birne -> pear
blaßrot -> pink
schnell -> rapidly
so -> so
wiedeerholen -> repeat
Klang -> sound
ablehnen -> refuse
Kühlschrank -> refrigerator
Strom -> stream
Frieden -> peace
Zweck -> purpose
nehmen -> take
Waffen -> weapons
Zeit -> time
zwanzig -> twenty
Schulter -> shoulder
Lautstärke -> volume
rot -> red
manchmal -> sometimes
Bemerkung -> remark
Mauer -> wall
Dienst -> service
prächtig -> splendid
dir -> to you
Aufgabe -> task
welchen -> whom
kurz -> short
reisen -> travel
verantwortlich -> responsible
verschieden -> various
einfach -> simple
Geschwindigkeit -> speed
Ort -> place
Schuhe -> shoes
aufziehen -> raise
zweiter -> second
was -> what
Löffel -> spoon
mehrere -> several
wirklich -> real
Student -> student
Obdach -> shelter
warm -> warm
dich -> you
vorbeugen -> prevent
willkommen -> welcome
Paar -> pair
Tee -> tea
Strasse -> street
ruhig -> quiet
Woche -> week
fremd -> strange
Schnee -> snow
Kurve -> turn
Lage -> position
tausend -> thousand
Grösse -> size
Gedanke -> thought
Zwetschge -> prune
sieben -> seven
während -> while
vielleicht -> perhaps
Fluss -> river
euer -> your
Stein -> stone
werfen -> throw
Parkieren -> parking
wild -> wild
erzählen -> tell
Theater -> theater
Stimme -> voice
zeigen -> show
Bevölkerung -> population
übersetzen -> translate
Strand -> shore
verringern -> reduce
Schweinefleisch -> pork
ohne -> without
reissen -> tear
Hemd -> shirt
rühren -> stir
Forschen -> research
Oberfläche -> surface
Telefon -> telephone
Gesellschaft -> society
Park -> park
eher -> rather
Haltestelle -> stop
aufstehen -> rise
warum -> why
vorbereiten -> prepare
scharf -> sharp
dienen als -> serve as
Kaninchen -> rabbit
Bühne -> stage
Temperatur -> temperature
Lastwagen -> truck
jung -> young
Jahreszeit -> season
kürzlich -> recently
Bleich -> pale
zufrieden -> satisfied
purpurfarbig -> purple
Topf -> pot
zurückbleiben -> remain
Sünde -> sin
Schwester -> sister
Dienstag -> Tuesday
Gemüse -> vegetable
vorheriger -> previous
seit -> since
Toilette -> toilet
Stück -> piece
roh -> raw
Erfolg -> success
Tränen -> tears
sicher -> safe
beliebt -> popular
wünschen -> wish
mit -> with
bitte -> please
Rock -> skirt
falsch -> wrong
sollen -> shall
ausbreiten -> spread
Landstrasse -> road
Wolle -> wool
möglich -> possible
Macht -> power
schreiben -> write
Sache -> thing
Königin -> queen
versuchen -> try
zusammen -> together
erkennen -> realize
traurig -> sad
unterstützen -> support
Raum -> space
Schere -> scissors
zahlen -> pay
stehen -> stand
wertlos -> worthless
einige -> some
Schirm -> umbrella
die -> the
kaum -> scarcely
Tisch -> table
Wort -> word
Ueberraschung -> surprise
tragen -> wear
schlimmer -> worse
selten -> rare
ihre -> their
sich erholen -> recover
Lage -> situation
Sturm -> storm
gelb -> yellow
Wurst -> sausage
Schutz -> protection
auswählen -> select
erhalten -> receive
Punkt -> point
Gegend -> region
nass -> wet
stolz -> proud
sicher -> sure
Signal -> signal
Erleichterung -> relief
Samstag -> Saturday
sehr -> very
Leute -> people
entfernen -> remove
suchen -> search
Sinn -> sense
fest -> solid
Aktie -> stock
Probe -> sample
auch -> too
solcher -> such
Lohn -> wage
Briefmarke -> stamp
Verhältnis -> relation
schwimmen -> swim
Gewicht -> weight
Programm -> program
zwei mal -> twice
Sonntag -> Sunday
Behandlung -> treatment
wer -> who
Mittwoch -> Wednesday
wo -> where
rund -> round
Fahrkarte -> ticket
scheinen -> seem
warten -> wait
Seite -> page
beginnen -> start
ob -> whether
Fels -> rock
gross -> tall
Party -> party
Zucker -> sugar
Erbe -> pea
mal -> times
Reifen -> tire
Hose -> trousers
Schwein -> pig
regnen -> rain
Preis -> price
siebzehn -> seventeen
Zahlung -> payment
zurückkehren -> return
arm -> poor
liefern -> provide
Treppe -> stairs
Süden -> south
Leistung -> performance
langsam -> slow
Krieg -> war
Durst -> thirst
Vergnügen -> pleasure
uns -> us
weiß -> white
so -> thus
klein -> small
wunderbar -> wonderful
schlafen -> sleep
welcher -> that
studieren -> study
reden -> talk
rein -> pure
auf -> up
Pflanze -> plant
Schwierigkeiten -> trouble
Qualität -> quality
Ofen -> stove
persönlich -> personal
sich erinnern -> remember
senden -> send
Schatten -> shadow
unterschreiben -> sign
starren -> stare
Eigentum -> property
Radio -> radio
streiten -> struggle
berichten -> report
abgemacht -> settled
Stahl -> steel